b	不 办 本 便 吧 被
c	出 参 才 处 常 产
d	的 队 到 多 点 定
f	发 费 否 风 房 法
g	个 改 工 各 光 关
h	和 红 坏 后 黑 活
j	就 即 机 今 叫 将
k	可 恳 克 科 肯 空
l	了 林 两 脸 路 冷
m	没 马 模 每 吗 美
n	你 能 弄 拿 呢 宁
p	平 陪 排 朋 跑 派
q	去 群 其 气 器 情
r	人 柔 热 入 肉 认
s	是 十 声 生 时 实
t	他 通 太 特 听 它
v	而 娥 耳 爱 啊 案
w	我 屋 王 位 网 问
x	下 信 现 行 些 学
y	一 以 要 月 业 与
z	在 再 走 知 只 这
bb	并不 半边 本报 不便 宝贝 不必
bc	不错 奔驰 变成 报仇 彼此 不曾
bd	不得 部队 表达 不但 宝典 不断
bf	办法 不妨 冰封 步伐 并非 北方
bg	不过 不敢 罢工 不管 曝光 不该
bh	保护 办好 变换 变化 编号 北海
bj	不仅 巴结 不禁 不久 背景 北京
bk	不肯 鼻孔 包括 本科 被困 博客
bl	本来 罢了 不理 巴黎 变量 不论
bm	部门 不妙 表面 罢免 表明 不满
bn	半年 不能 别扭 百年 保暖 不宁
bp	不怕 被骗 编排 被迫 本品 背叛
bq	并且 百强 版权 标签 兵器 表情
br	别人 不忍 变软 必然 本日 不容
bs	表示 本书 办事 本身 不少 比赛
bt	不同 不通 半天 摆脱 标题 包头
bv	不安 保安 北欧 不爱 彼岸 备案
bw	把握 保卫 百万 部位 包围 不问
bx	必须 保险 表现 不行 变小 不许
by	不要 不已 必要 本月 不易 表演
bz	不住 保障 不再 部长 帮助 保证
cb	出版 承办 成本 苍白 初步 传遍
cc	常常 传出 尺寸 匆匆 虫虫 层次
cd	程度 车队 颤抖 吃得 差点 彻底
cf	充分 长发 查封 吃饭 处罚 厨房
cg	成功 参观 超过 持股 成果 超高
ch	窗户 才好 策划 才会 称呼 仇恨
cj	参加 曾经 促进 长久 常见 吃惊
ck	此刻 诚恳 参考 查看 窗口 仓库
cl	出来 吃了 处理 彩铃 策略 材料
cm	充满 村民 场面 驰名 聪明 车门
cn	才能 超女 嘲弄 菜鸟 车内 承诺
cp	产品 彩屏 彩票 唱片 超频 裁判
cq	采取 超强 长期 春秋 插曲 重庆
cr	承认 脆弱 耻辱 仇人 春日 从容
cs	此时 纯属 传输 产生 才是 城市
ct	传统 出台 餐厅 朝廷 长叹 冲突
cv	从而 嫦娥 尘埃 宠爱 承恩 长安
cw	成为 创维 从未 窗外 春晚 错误
cx	出现 持续 呈现 朝鲜 晨曦 程序
cy	产业 诧异 参与 采用 成员 创意
cz	存在 车子 财政 操作 初中 穿着
db	代表 躲避 打扮 担保 地步 大半
dc	调查 单纯 达成 到处 点此 当初
dd	得到 导弹 达到 等待 地点 到底
df	地方 打发 颠覆 对付 大幅 东方
dg	大哥 大纲 大概 多个 德国 蛋糕
dh	的话 多好 动画 都会 带回 电话
dj	大家 大局 打击 多久 大叫 东京
dk	打开 打孔 贷款 都看 端口 带宽
dl	带来 大陆 道理 带领 大量 独立
dm	多么 大马 地面 多名 东盟 动漫
dn	多年 都能 东南 电脑 党内 大闹
dp	大批 肚皮 打破 大盘 毒品 点评
dq	地区 党群 的确 电气 电器 道歉
dr	当然 刀刃 打扰 敌人 冬日 点燃
ds	但是 读书 低声 打算 多少 电视
dt	点头 电台 动态 独特 打听 低头
dv	第二 窦娥 东欧 点儿 对啊 答案
dw	单位 大卫 第五 地位 电网 耽误
dx	东西 短线 地下 对象 弟兄 担心
dy	第一 大约 对于 地狱 电影 答应
dz	弟子 肚子 当真 动作 得罪 带着
fb	分别 反驳 发表 方便 腐败 封闭
fc	非常 付出 方才 风采 发财 房产
fd	反对 辅导 负担 非但 非典 奋斗
ff	方法 纷纷 防范 仿佛 吩咐 丰富
fg	法国 分隔 放过 分管 风光 覆盖
fh	发挥 粉红 防护 符合 返回 复活
fj	房间 福建 飞机 附近 风景 发觉
fk	放开 复垦 反抗 疯狂 封口 访客
fl	法律 翻了 飞龙 福利 房里 分类
fm	方面 父母 封面 风貌 仿冒 房门
fn	妇女 愤怒 抚弄 飞鸟 房内 烦恼
fp	分配 放屁 发票 扶贫 废品 反叛
fq	父亲 奉劝 夫妻 风气 分歧 放弃
fr	夫人 缝纫 繁荣 妇人 肥肉 否认
fs	发生 附属 方式 翻身 凡是 发送
ft	反弹 佛陀 封套 繁体 附图 法庭
fv	反而 份额 妨碍 风儿 飞蛾 方案
fw	服务 房屋 发威 飞舞 范围 访问
fx	发现 风险 分析 方向 反响 放心
fy	反应 法院 飞扬 费用 反映 发言
fz	发展 房子 负责 分钟 否则 非洲
gb	根本 改编 公布 官兵 告别 干部
gc	工程 高层 刚才 过程 歌唱 观察
gd	感到 宫殿 广大 孤独 观点 规定
gf	功夫 国防 规范 股份 高峰 广泛
gg	改革 更改 哥哥 各个 刚刚 古怪
gh	规划 搞好 更换 过后 光辉 关怀
gj	感觉 国际 根据 关键 工具 感激
gk	公开 管孔 高考 观看 港口 赶快
gl	管理 功力 鼓励 规律 公路 各类
gm	革命 购买 规模 改名 光明 歌迷
gn	姑娘 功能 赣南 观念 供暖 工农
gp	公平 滚屏 股票 光盘 高频 各派
gq	过去 光驱 供求 国企 歌曲 感情
gr	果然 刚柔 光荣 工人 骨肉 感染
gs	告诉 公司 故事 感受 更是 改善
gt	共同 沟通 国土 钢铁 感叹 骨头
gv	公安 关隘 故而 关爱 感恩 港澳
gw	各位 恭维 国王 怪物 官网 更为
gx	关系 光线 阁下 购销 功勋 高兴
gy	关于 怪异 共有 共用 工业 故意
gz	工作 故障 果真 各种 规则 跟着
hb	毫不 回避 回报 伙伴 河北 何必
hc	何处 画出 火车 好处 好吃 缓冲
hd	活动 混蛋 回到 回答 蝴蝶 皇帝
hf	恢复 花费 会否 回复 横幅 合法
hg	回归 宏观 回顾 火锅 韩国 很高
hh	缓缓 很好 绘画 狠狠 哈哈 后悔
hj	环境 韩剧 环节 黄金 罕见 喝酒
hk	很快 汗孔 汇款 回馈 户口 何况
hl	回来 活力 后来 混乱 喉咙 婚礼
hm	后面 黑马 号码 毫秒 好吗 昏迷
hn	河南 很难 湖南 怀念 回暖 胡闹
hp	害怕 黑屏 琥珀 魂魄 货品 好评
hq	回去 很强 好奇 花钱 火器 行情
hr	忽然 环绕 火热 华人 韩日 红润
hs	还是 回收 华硕 浑身 和尚 函数
ht	回头 后退 航天 话筒 话题 会谈
hv	黑暗 姮娥 和蔼 海尔 好啊 毫安
hw	毫无 后卫 好玩 海外 回味 化为
hx	或许 和弦 互相 好像 呼吸 核心
hy	还有 何以 还要 怀疑 行业 会议
hz	孩子 汉子 或者 合作 怀中 汉字
jb	基本 举办 绝不 肩膀 脚步 疾病
jc	基础 基层 坚持 进程 经常 警察
jd	觉得 绝对 见到 记得 监督 决定
jf	解放 经费 姐夫 肌肤 绝非 警方
jg	结果 交给 结构 尽管 金刚 机关
jh	几乎 结婚 计划 机会 惊呼 江湖
jj	经济 拒绝 积极 接近 紧紧 解决
jk	加快 祭孔 解开 紧靠 接口 健康
jl	建立 极了 将来 纪律 尽量 距离
jm	见面 居民 局面 经贸 节目 急忙
jn	今年 艰难 江南 近年 境内 拘泥
jp	金牌 精辟 机票 键盘 精品 浸泡
jq	加强 坚强 及其 健全 机器 交情
jr	进入 假如 金融 既然 今日 兼容
js	建设 介绍 技术 接受 加上 精神
jt	今天 交通 静态 具体 集团 家庭
jv	骄傲 金娥 继而 饥饿 激昂 金额
jw	极为 结尾 紧握 交往 今晚 绝望
jx	进行 继续 脚下 举行 揭晓 决心
jy	教育 经验 具有 监狱 就业 建议
jz	记者 紧张 简直 机制 集中 接着
kb	恐怖 捆绑 开本 空白 拷贝 看病
kc	看出 扣除 快车 课程 快餐 考察
kd	看到 刊登 扩大 口袋 快点 肯定
kf	开发 刊发 可否 克服 咖啡 开放
kg	客观 可观 快感 控股 跨国 开关
kh	客户 科幻 考核 抗衡 口号 快活
kj	看见 框架 科技 靠近 盔甲 空间
kk	看看 开垦 苦苦 可靠 空旷 慷慨
kl	看来 刻录 恐龙 快乐 考虑 可怜
km	开门 快马 开幕 科贸 昆明 苦闷
kn	可能 困难 柯南 渴念 课内 苦恼
kp	恐怕 开辟 开拍 卡片 宽频 科普
kq	口气 跨骑 开枪 客气 况且 开启
kr	客人 可忍 困扰 狂人 抗日 宽容
ks	开始 看书 快速 考生 口水 考试
kt	客厅 开通 开拓 卡特 课堂 空调
kv	可爱 看啊 可按 科尔 口岸 抗癌
kw	渴望 库娃 可恶 刊物 口味 看完
kx	科学 空隙 康熙 苦笑 空虚 可惜
ky	可以 考验 科研 可疑 开业 抗议
kz	控制 开展 客栈 可知 空中 靠着
lb	老板 两边 联邦 老爸 类别 脸部
lc	露出 楼层 立场 流程 理财 两次
ld	领导 脸蛋 来到 懒得 来电 力度
lf	浪费 裂缝 老夫 礼服 两幅 立法
lg	两国 乐观 掠过 旅馆 牢固 楼阁
lh	厉害 良好 灵魂 联合 老虎 冷汗
lj	立即 邻居 冷静 了解 冷峻 累计
lk	离开 脸孔 拉开 理科 路口 立刻
ll	理论 联络 连连 凌乱 力量 利率
lm	里面 罗马 路面 礼貌 联盟 连忙
ln	理念 鲁能 岭南 两年 冷暖 辽宁
lp	老婆 脸皮 连拍 楼盘 礼品 脸庞
lq	离去 列强 乐趣 力气 利器 恋情
lr	老人 例如 冷热 两人 落日 利润
ls	历史 螺丝 厉声 脸色 路上 落实
lt	老头 联通 楼梯 两条 聆听 龙头
lv	两岸 老媪 老二 恋爱 来啊 立案
lw	另外 螺纹 两万 礼物 联网 论文
lx	冷笑 连续 留下 联系 流星 良心
ly	利用 洛阳 领域 老爷 理由 利益
lz	来自 老子 老者 理智 两只 楼主
mb	明白 民办 目标 面包 漫步 毛病
mc	名称 冒出 马车 没错 没吃 每次
md	目的 摩登 猛地 矛盾 目睹 名单
mf	麻烦 免费 密封 埋伏 莫非 魔法
mg	美国 美观 玫瑰 某个 目光 迷宫
mh	模糊 美好 漫画 幕后 猛虎 门户
mj	面积 灭绝 民警 秘籍 模具 民间
mk	门口 毛孔 模块 每科 满口 没空
ml	美丽 魅力 忙碌 命令 面临 明亮
mm	慢慢 妈妈 买卖 面貌 默默 秘密
mn	美女 没能 模拟 每年 猛男 木讷
mp	门派 毛皮 门票 名牌 苗圃 面庞
mq	目前 勉强 明确 没钱 麻雀 母亲
mr	美人 毛绒 闷热 猛然 每日 面容
ms	马上 秘书 模式 面色 牧师 魔兽
mt	明天 每台 每天 媒体 煤炭 眉头
mv	名额 母爱 木耳 摩尔 蒙恩 命案
mw	门外 满屋 魔王 每位 美味 美文
mx	模型 冒险 梦想 面向 明显 描写
my	没有 绵阳 美元 每月 贸易 满意
mz	名字 帽子 免责 明知 满足 民族
nb	那边 泥巴 能把 那般 南北 宁波
nc	农村 拿出 内存 昵称 南昌 年初
nd	难道 能对 内地 年代 难点 年度
nf	能否 内附 那副 年份 那幅 奶粉
ng	那个 能给 难过 能够 凝固 难怪
nh	女孩 男孩 浓厚 年华 呐喊 怒火
nj	年纪 年级 宁静 脑筋 年鉴 南京
nk	难看 农垦 宁可 能看 那颗 内裤
nl	那里 努力 拿来 男篮 哪里 女郎
nm	你们 难民 内幕 那么 纽曼 纳米
nn	男女 奶奶 能耐 奶牛 喃喃 南宁
np	哪怕 牛皮 女排 涅盘 尿频 奶瓶
nq	年轻 那群 拿起 怒气 扭曲 弄清
nr	女人 懦弱 耐热 男人 牛肉 内容
ns	那时 浓缩 女士 难受 乃是 凝视
nt	念头 南通 泥土 那条 难题 扭头
nv	女儿 鸟儿 难熬 哪儿 南岸 脑癌
nw	那位 女娲 女王 哪位 内网 难忘
nx	那些 年限 宁夏 内向 哪些 女性
ny	那样 难以 女友 能用 农业 能源
nz	女子 男子 能在 那种 内置 拿着
pb	旁边 碰壁 屏蔽 配备 跑步 普遍
pc	平常 派出 跑车 赔偿 品尝 评测
pd	判断 排队 碰到 平等 盘点 频道
pf	佩服 批发 牌坊 皮肤 篇幅 配方
pg	屁股 旁观 皮革 评估 苹果 偏高
ph	破坏 偏好 破获 配合 批号 平滑
pj	平静 评级 平均 评价 瞥见 啤酒
pk	片刻 炮孔 抛开 偏科 贫困 凭空
pl	漂亮 跑了 披露 毗邻 批量 评论
pm	拼命 匹马 屏幕 排名 喷墨 平米
pn	陪你 泡妞 皮囊 便佞 睥睨 叛逆
pp	偏偏 屁屁 拍拍 品牌 频频 批评
pq	脾气 骠骑 跑去 喷泉 派遣 抛弃
pr	平日 譬如 疲软 仆人 皮肉 漂染
ps	平时 评书 拍摄 迫使 爬上 配送
pt	普通 平台 配套 胚胎 陪同 烹调
pv	平安 偏爱 皮埃 配偶 佩恩 配额
pw	颇为 片尾 喷雾 平稳 品味 盼望
px	培训 拍戏 剖析 评选 咆哮 排序
py	朋友 濮阳 颇有 飘逸 番禺 培养
pz	批准 牌子 碰撞 品种 配置 凭证
qb	全部 墙壁 情报 确保 前辈 欠扁
qc	清楚 取出 汽车 全程 清晨 其次
qd	取得 球队 全都 期待 起点 确定
qf	气氛 群发 勤奋 缺乏 岂非 气愤
qg	全国 奇观 情感 劝告 求购 奇怪
qh	前后 恰好 切换 强化 漆黑 侵害
qj	期间 全局 请教 全集 情景 奇迹
qk	情况 勤恳 期刊 请看 缺口 请客
ql	起来 权力 强烈 权利 千里 确立
qm	前面 巧妙 起码 签名 曲目 球迷
qn	去年 全能 气囊 青年 区内 气恼
qp	强迫 欺骗 汽配 亲朋 期盼 气派
qq	轻轻 牵强 请求 齐全 瞧瞧 悄悄
qr	情人 轻柔 亲热 亲人 秋日 确认
qs	其实 全书 轻松 全身 签署 确实
qt	其他 前台 前提 前途 企图 其它
qv	请按 邱隘 其二 企鹅 去啊 全额
qw	千万 前卫 权威 前往 趣味 请问
qx	情形 情绪 清醒 气息 清晰 取消
qy	企业 奇异 区域 其余 轻易 青衣
qz	其中 妻子 求职 群众 求助 庆祝
rb	日本 入编 日报 日版 让步 如冰
rc	如此 认出 人才 日程 日常 热潮
rd	人大 荣登 热带 认得 热点 认定
rf	若非 染发 瑞丰 如风 乳峰 乳房
rg	如果 扔给 若干 入股 认购 乳沟
rh	如何 染红 日韩 然后 如虹 润滑
rj	人家 人际 人均 如今 仍旧 人间
rk	人口 入孔 认可 仁科 入口 入库
rl	人类 热力 热烈 扰乱 容量 燃料
rm	人民 人马 热卖 人们 辱骂 热门
rn	热闹 人能 忍耐 人脑 入内 惹恼
rp	人品 肉皮 肉票 任凭 乳品 热评
rq	热情 人群 人权 人气 容器 柔情
rr	仍然 容忍 柔软 融入 嚷嚷 认认
rs	认识 人参 人士 人生 仍是 人数
rt	如同 融通 热土 软体 认同 让它
rv	然而 仁爱 入耳 热爱 人啊 乳癌
rw	认为 柔婉 仍未 任务 入围 人文
rx	人心 热线 如需 热血 瑞星 入学
ry	人员 人又 仍有 日月 容易 日益
rz	日子 入驻 认真 入住 日照 认证
sb	身边 手臂 上班 设备 失败 生病
sc	市场 伸出 时辰 深处 时常 生产
sd	说道 神殿 受到 似的 闪电 速度
sf	十分 沙发 是否 师父 山峰 算法
sg	送给 输给 事故 三个 收购 身高
sh	时候 嗜好 深厚 社会 收回 生活
sj	时间 世纪 数据 事件 世界 设计
sk	时刻 锁孔 思考 收看 伤口 深刻
sl	上来 实力 树林 顺利 商量 设立
sm	什么 市民 四面 生命 双目 沙漠
sn	少女 谁能 深南 少年 室内 水泥
sp	水平 受骗 审批 商铺 商品 身旁
sq	事情 四强 失去 生气 神器 神情
sr	虽然 瘦弱 骚扰 收入 生日 湿润
ss	身上 税收 收拾 伸手 算是 实施
st	身体 使她 生态 尸体 试题 石头
sv	是啊 素娥 十二 索爱 上岸 数额
sw	所谓 侍卫 尚未 上午 上网 死亡
sx	实现 视线 思想 首先 师兄 伤心
sy	所以 实验 所有 使用 事业 声音
sz	身子 始终 甚至 四周 手掌 随着
tb	特别 逃避 同比 同胞 台北 淘宝
tc	提出 突出 天才 特长 通常 陶瓷
td	听到 团队 土地 它的 特点 态度
tf	头发 突发 土匪 通风 天赋 投放
tg	通过 提纲 透过 提供 泰国 提高
th	谈话 挺好 桃花 同行 退回 童话
tj	条件 团结 推进 途径 听见 统计
tk	痛苦 瞳孔 推开 调侃 痛哭 天空
tl	讨论 听了 透露 条例 铁路 脱离
tm	他们 汤姆 条码 她们 透明 甜蜜
tn	头脑 它能 腾挪 童年 她呢 太浓
tp	谈判 调皮 突破 图片 逃跑 图谱
tq	提起 太强 同期 天气 天晴 同情
tr	突然 体弱 倘若 投入 兔肉 退让
ts	同时 图书 特殊 特色 踏上 听说
tt	太太 铁通 体坛 团体 听听 抬头
tv	图案 疼爱 退而 胎儿 天啊 提案
tw	台湾 条纹 天王 跳舞 突围 图文
tx	天下 投降 停下 体系 太小 同学
ty	统一 太阳 同样 通用 团员 体育
tz	同志 太子 调整 体制 停止 投资
vb	耳边 岸边 案板 欧版 阿贝 阿扁
vc	暗藏 二层 爱车 暗处 按此 暗忖
vd	耳朵 二队 殴打 爱得 阿呆 安定
vf	案犯 安防 安抚 而返 二幅 暗访
vg	而过 二姑 爱过 鞍钢 爱国 而该
vh	而后 爱好 爱护 安徽 暗黑 爱恨
vj	案件 二级 耳机 阿胶 暗叫 而将
vk	安康 耳孔 阿克 儿科 爱卡 尔康
vl	而来 饿了 二楼 案例 恶劣 暗恋
vm	澳门 鞍马 噩梦 奥秘 欧盟 欧美
vn	儿女 安妮 按扭 按钮 耳内 安宁
vp	安排 鞍辔 安培 矮胖 耳畔 阿婆
vq	而且 鹅群 哀求 二千 暗器 爱情
vr	偶然 鹅绒 阿荣 爱人 鹅肉 爱染
vs	昂首 盎司 二十 暗算 爱上 二室
vt	儿童 爱她 二厅 而逃 呕吐 额头
vv	偶尔 媕娿 偶而 恩爱 恩恩 哀哀
vw	安危 安慰 二万 额外 澳网 爱问
vx	恶心 凹陷 按下 偶像 矮小 爱心
vy	而已 欧阳 奥运 安逸 哎呀 遨游
vz	儿子 案子 挨揍 按住 按照 欧洲
wb	无比 尾巴 外表 五笔 晚辈 未必
wc	完成 挖出 维持 无处 晚餐 未曾
wd	问道 误导 伟大 无敌 万吨 稳定
wf	无法 无缝 潍坊 万分 雾峰 违法
wg	我国 外观 无辜 五个 王国 无关
wh	文化 未婚 维护 为何 挽回 武汉
wj	文件 未经 危机 五金 玩具 忘记
wk	我看 微孔 外壳 外科 网卡 悟空
wl	为了 网络 未来 为例 网路 无论
wm	我们 网民 帷幕 未免 文明 完美
wn	无奈 未能 玩弄 五年 温暖 污泥
wp	物品 顽皮 外拍 文凭 外频 外婆
wq	完全 委屈 为其 温泉 武器 无情
wr	温柔 围绕 微软 万人 往日 污染
ws	晚上 文书 武士 卫生 网上 完善
wt	问题 舞台 委托 物体 无图 外滩
wv	我爱 翁媪 无碍 为爱 巍峨 文案
ww	微微 娃娃 玩玩 往往 呜呜 问问
wx	微笑 危险 文献 威胁 卫星 文学
wy	唯一 无缘 万一 无疑 委员 网游
wz	位置 屋子 完整 握住 为止 文章
xb	宣布 下巴 相比 雪白 性别 西部
xc	形成 现出 现场 宣传 寻常 相差
xd	许多 相对 想到 显得 相当 兄弟
xf	幸福 消费 兴奋 相反 小幅 想法
xg	香港 修改 性格 相公 效果 习惯
xh	喜欢 小孩 相互 先后 信号 下滑
xj	小姐 下降 先进 现金 相见 选举
xk	胸口 姓孔 辛苦 学科 显卡 星空
xl	下来 训练 心理 旋律 线路 效率
xm	项目 兄妹 羡慕 性命 鲜明 厦门
xn	性能 新娘 虚拟 新年 校内 西宁
xp	新品 橡皮 选票 芯片 吓跑 夏普
xq	想起 先驱 兴趣 香气 镶嵌 心情
xr	显然 虚弱 羞辱 信任 昔日 笑容
xs	先生 吸收 迅速 学生 小时 现实
xt	系统 向她 夏天 胸膛 相同 协调
xv	喜爱 狭隘 邪恶 性爱 西岸 西安
xw	希望 纤维 虚无 下午 香味 行为
xx	相信 学习 学校 信息 星星 谢谢
xy	需要 吸引 小雨 信用 校园 协议
xz	现在 仙子 选择 乡镇 协助 向着
yb	一般 邮编 要不 以便 一步 一半
yc	因此 演出 隐藏 远处 异常 预测
yd	一定 引导 遇到 一代 一点 印度
yf	衣服 越发 一副 一番 一幅 依法
yg	应该 勇敢 严格 一股 眼光 有关
yh	以后 友好 疑惑 银行 隐患 用户
yj	已经 业绩 迎接 以及 眼睛 研究
yk	一块 圆孔 一款 依靠 一颗 愉快
yl	原来 压力 以来 娱乐 一路 眼泪
ym	一面 移民 迎面 以免 幽默 阴谋
yn	一年 也能 云南 意念 以内 旖旎
yp	一旁 荧屏 一批 影片 药品 一派
yq	一切 一群 要求 语气 仪器 以前
yr	依然 犹如 炎热 引入 羊肉 要让
ys	也是 严肃 艺术 一身 于是 意识
yt	摇头 一台 一套 一条 一听 丫头
yv	因而 要隘 悦耳 婴儿 阴暗 议案
yw	因为 鱼尾 一万 业务 夜晚 以为
yx	一些 有限 英雄 一向 有些 也许
yy	一样 医院 由于 应用 原因 愿意
yz	一直 一阵 一致 严重 原则 亚洲
zb	准备 嘴巴 再不 装备 逐步 转变
zc	支持 指出 造成 政策 正常 再次
zd	知道 指导 找到 只得 重点 制度
zf	政府 总发 丈夫 作风 涨幅 执法
zg	这个 整改 职工 整个 祖国 最高
zh	之后 只好 指挥 最后 招呼 珠海
zj	自己 增加 直接 资金 只见 之间
zk	召开 针孔 展开 专科 张口 状况
zl	这里 走了 总理 专利 质量 资料
zm	怎么 皱眉 字幕 这么 证明 专门
zn	只能 职能 指南 周年 之内 支农
zp	只怕 诈骗 招聘 照片 作品 最怕
zq	之前 增强 正确 赚钱 作曲 证券
zr	自然 诸如 最热 众人 昨日 转让
zs	只是 证书 正式 转身 真是 知识
zt	总统 这台 状态 整体 主题 增添
zv	这儿 祝阿 障碍 做爱 之恩 治安
zw	作为 皱纹 掌握 之外 周围 中文
zx	这些 仔细 之下 执行 最小 主席
zy	这样 早已 只有 作用 中央 注意
zz	正在 组织 真正 这种 之中 政治